1 1 1
Xjp
50 0 2017 6 20 21 0 0

1 1 2
Fly
48 0 2017 6 20 21 0 0

1 2 1
Cgb
20 0 2017 6 21 12 53 11

1 4 3
chen
1 0 2017 6 27 16 44 47

3 4 5
W
100 1 2017 6 19 21 0 0

